1111111111111
1001000000C01
1100011110011
1P011E0000011
1111111111111