1111111111111
10010000001C1
1000011000111
1P0001000E011
1111111111111