1111111111111
1E10000000001
1C10000000001
1P00000000001
1111111111111