1111111111111
1001000000C01
110001111I001
1P011E0000011
1111111111111